#######
#.....#
###.#.#
#&#.#.#
#.#.#.#
#..@..#
#######