#######
#&#...#
#.#.#.#
#..@#.#
###.###
#.....#
#######