################################################################################################################################################################
#-------------------#-------------------#-------------------#-------------------#-------------------#-------------------#-------------------#------------------#
#-------------------#-------------------#-------------------#-------------------#-------------------#-------------------#-------------------#------------------#
#-------------------#-------------------#-------------------#-------------------#-------------------#-------------------#-------------------#------------------#
#-------------------#-------------------#-------------------#-------------------#-------------------#-------------------#-------------------#------------------#
#-------------------#-------------------#-------------------#-------------------#-------------------#-------------------#-------------------#------------------#
#-------------------#-------------------#-------------------#-------------------#-------------------#-------------------#-------------------#------------------#
#---------@---------#-------------------#-------------------#-------------------#-------------------#-------------------#-------------------#------------------#
#-------------------#-------------------#-------------------#-------------------#-------------------#-------------------#-------------------#------------------#
#-------------------#-------------------#-------------------#-------------------#-------------------#-------------------#-------------------#------------------#
#-------------------#-------------------#-------------------#-------------------#-------------------#-------------------#-------------------#------------------#
#-------------------#-------------------#-------------------#-------------------#-------------------#-------------------#-------------------#------------------#
#-------------------#-------------------#-------------------#-------------------#-------------------#-------------------#-------------------#------------------#
#-------------------#-------------------#-------------------#-------------------#-------------------#-------------------#-------------------#------------------#
#-------------------#-------------------#-------------------#-------------------#-------------------#-------------------#-------------------#------------------#
#-------------------#-------------------#-------------------#-------------------#-------------------#-------------------#-------------------#------------------#
#-------------------#-------------------#-------------------#-------------------#-------------------#-------------------#-------------------#------------------#
#-------------------#-------------------#-------------------#-------------------#-------------------#-------------------#-------------------#------------------#
#-------------------#-------------------#-------------------#-------------------#-------------------#-------------------#-------------------#------------------#
#-------------------#-------------------#-------------------#-------------------#-------------------#-------------------#-------------------#------------------#
################################################################################################################################################################
#-------------------#-------------------#-------------------#-------------------#-------------------#-------------------#-------------------#------------------#
#-------------------#-------------------#-------------------#-------------------#-------------------#-------------------#-------------------#------------------#
#-------------------#-------------------#-------------------#-------------------#-------------------#-------------------#-------------------#------------------#
#-------------------#-------------------#-------------------#-------------------#-------------------#-------------------#-------------------#------------------#
#-------------------#-------------------#-------------------#-------------------#-------------------#-------------------#-------------------#------------------#
#-------------------#-------------------#-------------------#-------------------#-------------------#-------------------#-------------------#------------------#
#-------------------#-------------------#-------------------#-------------------#-------------------#-------------------#-------------------#------------------#
#-------------------#-------------------#-------------------#-------------------#-------------------#-------------------#-------------------#------------------#
#-------------------#-------------------#-------------------#-------------------#-------------------#-------------------#-------------------#------------------#
#-------------------#-------------------#-------------------#-------------------#-------------------#-------------------#-------------------#------------------#
#-------------------#-------------------#-------------------#-------------------#-------------------#-------------------#-------------------#------------------#
#-------------------#-------------------#-------------------#-------------------#-------------------#-------------------#-------------------#------------------#
#-------------------#-------------------#-------------------#-------------------#-------------------#-------------------#-------------------#------------------#
#-------------------#-------------------#-------------------#-------------------#-------------------#-------------------#-------------------#------------------#
#-------------------#-------------------#-------------------#-------------------#-------------------#-------------------#-------------------#------------------#
#-------------------#-------------------#-------------------#-------------------#-------------------#-------------------#-------------------#------------------#
#-------------------#-------------------#-------------------#-------------------#-------------------#-------------------#-------------------#------------------#
#-------------------#-------------------#-------------------#-------------------#-------------------#-------------------#-------------------#------------------#
#-------------------#-------------------#-------------------#-------------------#-------------------#-------------------#-------------------#------------------#
################################################################################################################################################################
#-------------------#-------------------#-------------------#-------------------#-------------------#-------------------#-------------------#------------------#
#-------------------#-------------------#-------------------#-------------------#-------------------#-------------------#-------------------#------------------#
#-------------------#-------------------#-------------------#-------------------#-------------------#-------------------#-------------------#------------------#
#-------------------#-------------------#-------------------#-------------------#-------------------#-------------------#-------------------#------------------#
#-------------------#-------------------#-------------------#-------------------#-------------------#-------------------#-------------------#------------------#
#-------------------#-------------------#-------------------#-------------------#-------------------#-------------------#-------------------#------------------#
#-------------------#-------------------#-------------------#-------------------#-------------------#-------------------#-------------------#------------------#
#-------------------#-------------------#-------------------#-------------------#-------------------#-------------------#-------------------#------------------#
#-------------------#-------------------#-------------------#-------------------#-------------------#-------------------#-------------------#------------------#
#-------------------#-------------------#-------------------#-------------------#-------------------#-------------------#-------------------#------------------#
#-------------------#-------------------#-------------------#-------------------#-------------------#-------------------#-------------------#------------------#
#-------------------#-------------------#-------------------#-------------------#-------------------#-------------------#-------------------#------------------#
#-------------------#-------------------#-------------------#-------------------#-------------------#-------------------#-------------------#------------------#
#-------------------#-------------------#-------------------#-------------------#-------------------#-------------------#-------------------#------------------#
#-------------------#-------------------#-------------------#-------------------#-------------------#-------------------#-------------------#------------------#
#-------------------#-------------------#-------------------#-------------------#-------------------#-------------------#-------------------#------------------#
#-------------------#-------------------#-------------------#-------------------#-------------------#-------------------#-------------------#------------------#
#-------------------#-------------------#-------------------#-------------------#-------------------#-------------------#-------------------#------------------#
#-------------------#-------------------#-------------------#-------------------#-------------------#-------------------#-------------------#------------------#
################################################################################################################################################################
#-------------------#-------------------#-------------------#-------------------#-------------------#-------------------#-------------------#------------------#
#-------------------#-------------------#-------------------#-------------------#-------------------#-------------------#-------------------#------------------#
#-------------------#-------------------#-------------------#-------------------#-------------------#-------------------#-------------------#------------------#
#-------------------#-------------------#-------------------#-------------------#-------------------#-------------------#-------------------#------------------#
#-------------------#-------------------#-------------------#-------------------#-------------------#-------------------#-------------------#------------------#
#-------------------#-------------------#-------------------#-------------------#-------------------#-------------------#-------------------#------------------#
#-------------------#-------------------#-------------------#-------------------#-------------------#-------------------#-------------------#------------------#
#-------------------#-------------------#-------------------#-------------------#-------------------#-------------------#-------------------#------------------#
#-------------------#-------------------#-------------------#-------------------#-------------------#-------------------#-------------------#------------------#
#-------------------#-------------------#-------------------#-------------------#-------------------#-------------------#-------------------#------------------#
#-------------------#-------------------#-------------------#-------------------#-------------------#-------------------#-------------------#------------------#
#-------------------#-------------------#-------------------#-------------------#-------------------#-------------------#-------------------#------------------#
#-------------------#-------------------#-------------------#-------------------#-------------------#-------------------#-------------------#------------------#
#-------------------#-------------------#-------------------#-------------------#-------------------#-------------------#-------------------#------------------#
#-------------------#-------------------#-------------------#-------------------#-------------------#-------------------#-------------------#------------------#
#-------------------#-------------------#-------------------#-------------------#-------------------#-------------------#-------------------#------------------#
#-------------------#-------------------#-------------------#-------------------#-------------------#-------------------#-------------------#------------------#
#-------------------#-------------------#-------------------#-------------------#-------------------#-------------------#-------------------#------------------#
#-------------------#-------------------#-------------------#-------------------#-------------------#-------------------#-------------------#------------------#
################################################################################################################################################################
#-------------------#-------------------#-------------------#-------------------#-------------------#-------------------#-------------------#------------------#
#-------------------#-------------------#-------------------#-------------------#-------------------#-------------------#-------------------#------------------#
#-------------------#-------------------#-------------------#-------------------#-------------------#-------------------#-------------------#------------------#
#-------------------#-------------------#-------------------#-------------------#-------------------#-------------------#-------------------#------------------#
#-------------------#-------------------#-------------------#-------------------#-------------------#-------------------#-------------------#------------------#
#-------------------#-------------------#-------------------#-------------------#-------------------#-------------------#-------------------#------------------#
#-------------------#-------------------#-------------------#-------------------#-------------------#-------------------#-------------------#------------------#
#-------------------#-------------------#-------------------#-------------------#-------------------#-------------------#-------------------#------------------#
#-------------------#-------------------#-------------------#-------------------#-------------------#-------------------#-------------------#------------------#
#-------------------#-------------------#-------------------#-------------------#-------------------#-------------------#-------------------#------------------#
#-------------------#-------------------#-------------------#-------------------#-------------------#-------------------#-------------------#------------------#
#-------------------#-------------------#-------------------#-------------------#-------------------#-------------------#-------------------#------------------#
#-------------------#-------------------#-------------------#-------------------#-------------------#-------------------#-------------------#------------------#
#-------------------#-------------------#-------------------#-------------------#-------------------#-------------------#-------------------#------------------#
#-------------------#-------------------#-------------------#-------------------#-------------------#-------------------#-------------------#------------------#
#-------------------#-------------------#-------------------#-------------------#-------------------#-------------------#-------------------#------------------#
#-------------------#-------------------#-------------------#-------------------#-------------------#-------------------#-------------------#------------------#
#-------------------#-------------------#-------------------#-------------------#-------------------#-------------------#-------------------#------------------#
#-------------------#-------------------#-------------------#-------------------#-------------------#-------------------#-------------------#------------------#
################################################################################################################################################################
#-------------------#-------------------#-------------------#-------------------#-------------------#-------------------#-------------------#------------------#
#-------------------#-------------------#-------------------#-------------------#-------------------#-------------------#-------------------#------------------#
#-------------------#-------------------#-------------------#-------------------#-------------------#-------------------#-------------------#------------------#
#-------------------#-------------------#-------------------#-------------------#-------------------#-------------------#-------------------#------------------#
#-------------------#-------------------#-------------------#-------------------#-------------------#-------------------#-------------------#------------------#
#-------------------#-------------------#-------------------#-------------------#-------------------#-------------------#-------------------#------------------#
#-------------------#-------------------#-------------------#-------------------#-------------------#-------------------#-------------------#------------------#
#-------------------#-------------------#-------------------#-------------------#-------------------#-------------------#-------------------#------------------#
#-------------------#-------------------#-------------------#-------------------#-------------------#-------------------#-------------------#------------------#
#-------------------#-------------------#-------------------#-------------------#-------------------#-------------------#-------------------#------------------#
#-------------------#-------------------#-------------------#-------------------#-------------------#-------------------#-------------------#------------------#
#-------------------#-------------------#-------------------#-------------------#-------------------#-------------------#-------------------#------------------#
#-------------------#-------------------#-------------------#-------------------#-------------------#-------------------#-------------------#------------------#
#-------------------#-------------------#-------------------#-------------------#-------------------#-------------------#-------------------#------------------#
#-------------------#-------------------#-------------------#-------------------#-------------------#-------------------#-------------------#------------------#
#-------------------#-------------------#-------------------#-------------------#-------------------#-------------------#-------------------#------------------#
#-------------------#-------------------#-------------------#-------------------#-------------------#-------------------#-------------------#------------------#
#-------------------#-------------------#-------------------#-------------------#-------------------#-------------------#-------------------#------------------#
#-------------------#-------------------#-------------------#-------------------#-------------------#-------------------#-------------------#------------------#
################################################################################################################################################################
#-------------------#-------------------#-------------------#-------------------#-------------------#-------------------#-------------------#------------------#
#-------------------#-------------------#-------------------#-------------------#-------------------#-------------------#-------------------#------------------#
#-------------------#-------------------#-------------------#-------------------#-------------------#-------------------#-------------------#------------------#
#-------------------#-------------------#-------------------#-------------------#-------------------#-------------------#-------------------#------------------#
#-------------------#-------------------#-------------------#-------------------#-------------------#-------------------#-------------------#------------------#
#-------------------#-------------------#-------------------#-------------------#-------------------#-------------------#-------------------#------------------#
#-------------------#-------------------#-------------------#-------------------#-------------------#-------------------#-------------------#------------------#
#-------------------#-------------------#-------------------#-------------------#-------------------#-------------------#-------------------#------------------#
#-------------------#-------------------#-------------------#-------------------#-------------------#-------------------#-------------------#------------------#
#-------------------#-------------------#-------------------#-------------------#-------------------#-------------------#-------------------#------------------#
#-------------------#-------------------#-------------------#-------------------#-------------------#-------------------#-------------------#------------------#
#-------------------#-------------------#-------------------#-------------------#-------------------#-------------------#-------------------#------------------#
#-------------------#-------------------#-------------------#-------------------#-------------------#-------------------#-------------------#------------------#
#-------------------#-------------------#-------------------#-------------------#-------------------#-------------------#-------------------#------------------#
#-------------------#-------------------#-------------------#-------------------#-------------------#-------------------#-------------------#------------------#
#-------------------#-------------------#-------------------#-------------------#-------------------#-------------------#-------------------#------------------#
#-------------------#-------------------#-------------------#-------------------#-------------------#-------------------#-------------------#------------------#
#-------------------#-------------------#-------------------#-------------------#-------------------#-------------------#-------------------#------------------#
#-------------------#-------------------#-------------------#-------------------#-------------------#-------------------#-------------------#------------------#
################################################################################################################################################################
#-------------------#-------------------#-------------------#-------------------#-------------------#-------------------#-------------------#------------------#
#-------------------#-------------------#-------------------#-------------------#-------------------#-------------------#-------------------#------------------#
#-------------------#-------------------#-------------------#-------------------#-------------------#-------------------#-------------------#------------------#
#-------------------#-------------------#-------------------#-------------------#-------------------#-------------------#-------------------#------------------#
#-------------------#-------------------#-------------------#-------------------#-------------------#-------------------#-------------------#------------------#
#-------------------#-------------------#-------------------#-------------------#-------------------#-------------------#-------------------#------------------#
#-------------------#-------------------#-------------------#-------------------#-------------------#-------------------#-------------------#------------------#
#-------------------#-------------------#-------------------#-------------------#-------------------#-------------------#-------------------#------------------#
#-------------------#-------------------#-------------------#-------------------#-------------------#-------------------#-------------------#------------------#
#-------------------#-------------------#-------------------#-------------------#-------------------#-------------------#-------------------#------------------#
#-------------------#-------------------#-------------------#-------------------#-------------------#-------------------#-------------------#------------------#
#-------------------#-------------------#-------------------#-------------------#-------------------#-------------------#-------------------#------------------#
#-------------------#-------------------#-------------------#-------------------#-------------------#-------------------#-------------------#------------------#
#-------------------#-------------------#-------------------#-------------------#-------------------#-------------------#-------------------#------------------#
#-------------------#-------------------#-------------------#-------------------#-------------------#-------------------#-------------------#------------------#
#-------------------#-------------------#-------------------#-------------------#-------------------#-------------------#-------------------#------------------#
#-------------------#-------------------#-------------------#-------------------#-------------------#-------------------#-------------------#------------------#
#-------------------#-------------------#-------------------#-------------------#-------------------#-------------------#-------------------#------------------#
################################################################################################################################################################