#######
#.....#
###.###
#..@..#
###.###
#....&#
#######