###########
#...#.#...#
###.#.#.###
#.....#.#.#
#####.#.#.#
#@........#
###.#######
#.#.......#
#.#.#.###.#
#...#...#&#
###########