#########################################
#.#.#.#.#.#.#.#.#.#.#.#.#.#.#.#.#.#.#.#.#
#########################################
#.#.#.#.#.#.#.#.#.#.#.#.#.#.#.#.#.#.#.#.#
#########################################
#.#.#.#.#.#.#.#.#.#.#.#.#.#.#.#.#.#.#.#.#
#########################################
#.#.#.#.#.#.#.#.#.#.#.#.#.#.#.#.#.#.#.#.#
#########################################
#.#.#.#.#.#.#.#.#.#.#.#.#.#.#.#.#.#.#.#.#
#########################################
#.#.#.#.#.#.#.#.#.#.#.#.#.#.#.#.#.#.#.#.#
#########################################
#.#.#.#.#.#.#.#.#.#.#.#.#.#.#.#.#.#.#.#.#
#########################################
#.#.#.#.#.#.#.#.#.#.#.#.#.#.#.#.#.#.#.#.#
#########################################
#.#.#.#.#.#.#.#.#.#.#.#.#.#.#.#.#.#.#.#.#
#########################################
#.#.#.#.#.#.#.#.#.#.#.#.#.#.#.#.#.#.#.#.#
#########################################
#.#.#.#.#.#.#.#.#.#.#.#.#.#.#.#.#.#.#.#.#
#########################################
#.#.#.#.#.#.#.#.#.#.#.#.#.#.#.#.#.#.#.#.#
#########################################
#.#.#.#.#.#.#.#.#.#.#.#.#.#.#.#.#.#.#.#.#
#########################################
#.#.#.#.#.#.#.#.#.#.#.#.#.#.#.#.#.#.#.#.#
#########################################
#.#.#.#.#.#.#.#.#.#.#.#.#.#.#.#.#.#.#.#.#
#########################################
#.#.#.#.#.#.#.#.#.#.#.#.#.#.#.#.#.#.#.#.#
#########################################
#.#.#.#.#.#.#.#.#.#.#.#.#.#.#.#.#.#.#.#.#
#########################################
#.#.#.#.#.#.#.#.#.#.#.#.#.#.#.#.#.#.#.#.#
#########################################
#.#.#.#.#.#.#.#.#.#.#.#.#.#.#.#.#.#.#.#.#
#########################################
#.#.#.#.#.#.#.#.#.#.#.#.#.#.#.#.#.#.#.#.#
#########################################