###########
#...#.....#
#.###.#####
#.#.#...#.#
#.#.#.###.#
#.....#.#.#
#.#.###.#.#
#.#.....#.#
#.###.###.#
#...#.....#
###########