###########
#......@..#
###.#.#.#.#
#...#...#.#
###.#####.#
#.......#.#
###.#######
#.........#
#.###.#####
#&#.......#
###########