#########################################
#.#.#...#.......#.........#.....#.#.#...#
#.#.###.#######.#.#####.#.###.###.#.#.###
#...#...#...........#.#.#.#.#.........#.#
#.#.###.#######.#.###.#####.#.#########.#
#.#...........#.#...#.#...#.......#...#.#
#############.#.#.#.#.###.#.#########.#.#
#...#.....#.....#.#.#.#...#.....#.#...#.#
#.#######.#######.#.#.#.#.###.###.###.#.#
#.#.....#...#.#.#.#.#...#.#...........#.#
#.#####.###.#.#.###.#.#.#####.###.#.###.#
#.#...#.#.........#.#.#.#.....#.#.#.#.#.#
#.###.#.###.#####.#.#.#.#######.#.###.#.#
#.#.#.....#...#.......#.#.#...#...#...#.#
#.#.#.#.#######.#.#.###.#.###.#.#####.#.#
#.#...#.......#.#.#.#...#.#.....#...#...#
#.###.###.#########.###.#.#.###.#.#.#.###
#...#.#.#...#...#.....#.#.#...#.#.#.....#
#.#.#.#.#.###.#########.#.#.#.#.###.#.###
#.#...#.#...#...#...#...#.#.#.#.....#...#
###.###.#####.#####.###.#.#####.###.#.###
#...#.#.....#.#...#.......#.#...#.#.#.#.#
###.#.#.#####.#.###.#####.#.#.###.#####.#
#.......#.#.#.....#.#.#.......#.......#.#
#####.###.#.#####.#.#.#.#####.#.#####.#.#
#...#.#.......#.#...#...#.....#.#...#.#.#
###.#.###.#####.###########.###.###.###.#
#.#.....#...#.#.#...#.#...#...#.#.......#
#.#.###.###.#.#.#.###.###.###.#.#.#######
#.#...#...#...........#.....#.#...#.#.#.#
#.#######.###.#.#####.###.#.#.#.###.#.#.#
#...#.......#.#.#.#...#...#.....#.#.....#
###.#####.#.#.#.#.###.#####.###.#.#.#.#.#
#.#.#.#.#.#...#.#.#.#.......#.......#.#.#
#.#.#.#.#.#.#####.#.#####.###.###.###.###
#.........#.#.#.#...#.......#.#.#.#.#...#
#.#####.#.#.#.#.#.###.#######.#.#.#.###.#
#.....#.#.#.#...............#...#.....#.#
#.#.#.#.###.#.#.#.#.###.#.#######.###.###
#.#.#.#.#...#.#.#.#...#.#.......#.#.....#
#########################################