###########
#.#...#.#.#
#.###.#.#.#
#...#.....#
###.#.###.#
#.....#...#
###.#.#.#.#
#...#.#.#.#
###.###.###
#.....#...#
###########