#######
#.#@..#
#.#.###
#.....#
#.#.#.#
#&#.#.#
#######