############
#......#...#
#..###...#.#
#...@...##.#
#..#....#..#
#..#...###.#
#....#.....#
############