#######
#...#.#
###.#.#
#..@#.#
###.#.#
#....&#
#######