###########
#.....#..@#
#.###.#.###
#.#.......#
#.#.#.###.#
#.#.#.#.#.#
#.#.#.#.#.#
#.#.#...#.#
#.#.###.#.#
#&#.#...#.#
###########