#######
#.#..&#
#.#.###
#.....#
#.###.#
#@..#.#
#######