###########
#.#...#&..#
#.###.#.###
#.#.......#
#.###.###.#
#..@..#.#.#
#####.#.###
#...#.....#
#.#.#.#####
#.#.......#
###########