#######
#@....#
###.#.#
#...#.#
#.#####
#....&#
#######