###########
#.#.#.#...#
#.#.#.#.###
#.....#.#.#
#.###.#.#.#
#.#.#...#.#
###.###.#.#
#.#.......#
#.#####.###
#.........#
###########