###########
#.......#.#
#####.#.#.#
#.....#..@#
###.#.#.#.#
#...#.#.#.#
#.#####.###
#...#...#.#
#.#.#.#.#.#
#.#&#.#...#
###########