###########
#...#...#.#
#.#.#.#.#.#
#.#..@#...#
#.###.#.###
#.#.......#
#####.###.#
#...#.#...#
#.#.#.#.#.#
#.#...#.#&#
###########