#######
#&....#
###.###
#.....#
#####.#
#....@#
#######