#######
#@....#
#.###.#
#.#...#
#.###.#
#..&#.#
#######