#######
#.#.#.#
#.#.#.#
#.#@..#
#.#.#.#
#...#&#
#######